R 1920 1080
NO ./texture/map
SO ./texture/map
WE ./texture/map
EA ./texture/map

S ./texture/sprite
F 220,100,0
C 225,30,0

1 1 1 1 1               111
100011
100011111
1100000011111
1001110001
100000011
100110011111111111
100000000000000001
111111111111000001111
111111111111000000001
111111111110000001001
111000000000000111101
111001111111110111101
111001111111110111101
111001111111110111101
111001111111110111101
111000000000000000001
11111111111111111111
