R 1920 1080
NO ./texture/map
SO ./texture/map
WE ./texture/map
EA ./texture/map

S ./texture/sprite
F 220,100,0
C 225,30,0

111111
100011
100011
110011
100111
100001
111111
